31x31
Assets/Sprites/Tile 1.png%WALL
Assets/Sprites/Tile 2.png%WALL
Assets/Sprites/Tile 3.png%WALL
Assets/Sprites/Tile 4.png%WALL
Assets/Sprites/Corner 1.png%WALL
Assets/Sprites/Corner 2.png%WALL
Assets/Sprites/Corner 3.png%WALL
Assets/Sprites/Corner 4.png%WALL
Assets/Sprites/Corner 1-3.png%WALL
Assets/Sprites/Corner 2-3.png%WALL
Assets/Sprites/Corner 1-4.png%WALL
Assets/Sprites/Corner 2-4.png%WALL
Assets/Sprites/Floor.png%NORMAL
Assets/Sprites/Door.png%DOOR
Assets/Sprites/TP 1.png%TELEPORTATION
Assets/Sprites/TP 2.png%TELEPORTATION
Assets/Sprites/TP 3.png%TELEPORTATION
Assets/Sprites/TP 4.png%TELEPORTATION
Assets/Sprites/TP 5.png%TELEPORTATION
Assets/Sprites/TP 6.png%TELEPORTATION
Assets/Sprites/TP 7.png%TELEPORTATION
Assets/Sprites/TP 8.png%TELEPORTATION
Assets/Sprites/TP 9.png%TELEPORTATION
Assets/Sprites/TP 10.png%TELEPORTATION
Assets/Sprites/TP 11.png%TELEPORTATION
Assets/Sprites/TP 12.png%TELEPORTATION
Assets/Sprites/TP 13.png%TELEPORTATION
Assets/Sprites/TP 14.png%TELEPORTATION
Assets/Sprites/TP 15.png%TELEPORTATION
*
1 0 1 0
0 1 0 1
1 1 0 0
0 0 1 1
0 0 1 0
1 0 0 0
0 1 0 0
0 0 0 1
1 1 1 0
1 1 0 1
1 0 1 1
0 1 1 1
0 0 0 0
0 0 1 1
1 1 0 0
0 0 0 0
0 0 1 1
0 0 0 0
0 0 0 0
1 1 0 0
0 0 0 0
0 0 1 1
0 1 0 1
0 0 0 0
1 0 1 0
1 0 1 0
0 0 0 0
0 1 0 1
0 0 0 0
{
0,0,0,19,29,19,0,0,0,0,0,0,0,0,0,0,0,0,0,0,0,0,0,0,0,19,29,19,0,0,0,
0,0,0,25,24,23,0,0,0,0,0,0,0,0,0,0,0,0,0,0,0,0,0,0,0,25,24,23,0,0,0,
0,0,0,1,13,7,3,3,3,3,3,3,3,3,3,3,3,3,3,3,3,3,3,3,3,6,13,2,0,0,0,
0,0,0,1,13,13,13,13,13,13,13,13,13,13,13,13,13,13,13,13,13,13,13,13,13,13,13,2,0,0,0,
0,0,0,1,13,8,4,5,13,8,4,4,4,4,5,13,8,4,4,4,4,5,13,8,4,5,13,2,0,0,0,
19,15,3,6,13,2,13,1,13,2,0,0,0,0,1,13,2,0,0,0,0,1,13,2,13,1,13,7,3,20,19,
18,16,13,13,13,2,13,1,13,2,0,0,0,0,1,13,2,0,0,0,0,1,13,2,13,1,13,13,13,21,18,
19,17,4,4,4,12,13,1,13,2,0,0,0,0,1,13,2,0,0,0,0,1,13,2,13,11,4,4,4,22,19,
0,0,9,3,3,3,3,6,13,2,0,0,0,0,1,13,2,0,0,0,0,1,13,7,3,3,3,3,10,0,0,
0,0,1,13,13,13,13,13,13,2,0,0,0,0,1,13,2,0,0,0,0,1,13,13,13,13,13,13,2,0,0,
0,0,1,13,8,4,4,4,4,12,0,0,0,0,1,13,2,0,0,0,0,11,4,4,4,4,5,13,2,0,0,
0,0,1,13,2,0,0,0,0,0,0,0,0,0,1,13,2,0,0,0,0,0,0,0,0,0,1,13,2,0,0,
0,0,1,13,2,0,0,0,0,0,0,0,0,0,1,13,2,0,0,0,0,0,0,0,0,0,1,13,2,0,0,
0,0,1,13,2,0,0,0,0,0,0,0,0,0,1,13,2,0,0,0,0,0,0,0,0,0,1,13,2,0,0,
0,0,1,13,7,3,3,3,3,3,3,3,3,3,6,13,7,3,3,3,3,3,3,3,3,3,6,13,2,0,0,
0,0,1,13,13,13,13,13,13,13,13,13,13,13,13,13,13,13,13,13,13,13,13,13,13,13,13,13,2,0,0,
0,0,1,13,8,4,4,4,4,4,4,4,4,4,5,13,8,4,4,4,4,4,4,4,4,4,5,13,2,0,0,
0,0,1,13,2,0,0,0,0,0,0,0,0,0,1,13,2,0,0,0,0,0,0,0,0,0,1,13,2,0,0,
0,0,1,13,2,0,0,0,0,0,0,0,0,0,1,13,2,0,0,0,0,0,0,0,0,0,1,13,2,0,0,
0,0,1,13,2,0,0,0,0,0,0,0,0,0,1,13,2,0,0,0,0,0,0,0,0,0,1,13,2,0,0,
0,0,1,13,7,3,3,3,3,10,0,0,0,0,1,13,2,0,0,0,0,9,3,3,3,3,6,13,2,0,0,
0,0,1,13,13,13,13,13,13,2,0,0,0,0,1,13,2,0,0,0,0,1,13,13,13,13,13,13,2,0,0,
0,0,11,4,4,4,4,5,13,2,0,0,0,0,1,13,2,0,0,0,0,1,13,8,4,4,4,4,12,0,0,
19,15,3,3,3,10,3,1,13,2,0,0,0,0,1,13,2,0,0,0,0,1,13,2,3,9,3,3,3,20,19,
18,16,13,13,13,2,13,1,13,2,0,0,0,0,1,13,2,0,0,0,0,1,13,2,13,1,13,13,13,21,18,
19,17,4,5,13,2,13,1,13,2,0,0,0,0,1,13,2,0,0,0,0,1,13,2,13,1,13,8,4,22,19,
0,0,0,1,13,7,3,6,13,7,3,3,3,3,6,13,7,3,3,3,3,6,13,7,3,6,13,2,0,0,0,
0,0,0,1,13,13,13,13,13,13,13,13,13,13,13,13,13,13,13,13,13,13,13,13,13,13,13,2,0,0,0,
0,0,0,1,13,8,4,4,4,4,4,4,4,4,4,4,4,4,4,4,4,4,4,4,4,5,13,2,0,0,0,
0,0,0,26,27,28,0,0,0,0,0,0,0,0,0,0,0,0,0,0,0,0,0,0,0,26,27,28,0,0,0,
0,0,0,19,29,19,0,0,0,0,0,0,0,0,0,0,0,0,0,0,0,0,0,0,0,19,29,19,0,0,0
}
4, 0, UP , 26, 0, UP ,
0, 6, LEFT , 29, 6, RIGHT ,
0, 24, LEFT , 29, 24, RIGHT ,
4, 29, DOWN , 26, 29, DOWN $
Assets/Sprites/Point 1.png%NORMAL 10
Assets/Sprites/Point 2.png%POWER 50
{
0,0,0,0,0,0,0,0,0,0,0,0,0,0,0,0,0,0,0,0,0,0,0,0,0,0,0,0,0,0,0,
0,0,0,0,0,0,0,0,0,0,0,0,0,0,0,0,0,0,0,0,0,0,0,0,0,0,0,0,0,0,0,
0,0,0,0,30,0,0,0,0,0,0,0,0,0,0,0,0,0,0,0,0,0,0,0,0,0,30,0,0,0,0,
0,0,0,0,30,30,30,30,30,30,30,30,30,30,30,31,30,30,30,30,30,30,30,30,30,30,30,0,0,0,0,
0,0,0,0,30,0,0,0,30,0,0,0,0,0,0,30,0,0,0,0,0,0,30,0,0,0,30,0,0,0,0,
0,0,0,0,30,0,0,0,30,0,0,0,0,0,0,30,0,0,0,0,0,0,30,0,0,0,30,0,0,0,0,
0,0,0,30,30,0,0,0,30,0,0,0,0,0,0,30,0,0,0,0,0,0,30,0,0,0,30,30,30,0,0,
0,0,0,0,0,0,0,0,30,0,0,0,0,0,0,30,0,0,0,0,0,0,30,0,0,0,0,0,0,0,0,
0,0,0,0,0,0,0,0,30,0,0,0,0,0,0,30,0,0,0,0,0,0,30,0,0,0,0,0,0,0,0,
0,0,0,30,30,30,30,30,30,0,0,0,0,0,0,30,0,0,0,0,0,0,30,30,30,30,30,30,0,0,0,
0,0,0,30,0,0,0,0,0,0,0,0,0,0,0,30,0,0,0,0,0,0,0,0,0,0,0,30,0,0,0,
0,0,0,30,0,0,0,0,0,0,0,0,0,0,0,30,0,0,0,0,0,0,0,0,0,0,0,30,0,0,0,
0,0,0,30,0,0,0,0,0,0,0,0,0,0,0,30,0,0,0,0,0,0,0,0,0,0,0,30,0,0,0,
0,0,0,30,0,0,0,0,0,0,0,0,0,0,0,30,0,0,0,0,0,0,0,0,0,0,0,30,0,0,0,
0,0,0,30,0,0,0,0,0,0,0,0,0,0,0,30,0,0,0,0,0,0,0,0,0,0,0,30,0,0,0,
0,0,0,31,30,30,30,30,30,30,30,30,30,30,30,30,30,30,30,30,30,30,30,30,30,30,30,31,0,0,0,
0,0,0,30,0,0,0,0,0,0,0,0,0,0,0,30,0,0,0,0,0,0,0,0,0,0,0,30,0,0,0,
0,0,0,30,0,0,0,0,0,0,0,0,0,0,0,30,0,0,0,0,0,0,0,0,0,0,0,30,0,0,0,
0,0,0,30,0,0,0,0,0,0,0,0,0,0,0,30,0,0,0,0,0,0,0,0,0,0,0,30,0,0,0,
0,0,0,30,0,0,0,0,0,0,0,0,0,0,0,30,0,0,0,0,0,0,0,0,0,0,0,30,0,0,0,
0,0,0,30,0,0,0,0,0,0,0,0,0,0,0,30,0,0,0,0,0,0,0,0,0,0,0,30,0,0,0,
0,0,0,30,30,30,30,30,30,0,0,0,0,0,0,30,0,0,0,0,0,0,30,30,30,30,30,30,0,0,0,
0,0,0,0,0,0,0,0,30,0,0,0,0,0,0,30,0,0,0,0,0,0,30,0,0,0,0,0,0,0,0,
0,0,0,0,0,0,0,0,30,0,0,0,0,0,0,30,0,0,0,0,0,0,30,0,0,0,0,0,0,0,0,
0,0,30,30,30,0,0,0,30,0,0,0,0,0,0,30,0,0,0,0,0,0,30,0,0,0,30,30,30,0,0,
0,0,0,0,30,0,0,0,30,0,0,0,0,0,0,30,0,0,0,0,0,0,30,0,0,0,30,0,0,0,0,
0,0,0,0,30,0,0,0,30,0,0,0,0,0,0,30,0,0,0,0,0,0,30,0,0,0,30,0,0,0,0,
0,0,0,0,30,30,30,30,30,30,30,30,30,30,30,31,30,30,30,30,30,30,30,30,30,30,30,0,0,0,0,
0,0,0,0,30,0,0,0,0,0,0,0,0,0,0,0,0,0,0,0,0,0,0,0,0,0,30,0,0,0,0,
0,0,0,0,0,0,0,0,0,0,0,0,0,0,0,0,0,0,0,0,0,0,0,0,0,0,0,0,0,0,0,
0,0,0,0,0,0,0,0,0,0,0,0,0,0,0,0,0,0,0,0,0,0,0,0,0,0,0,0,0,0,0
}
231 231
