32x31
Assets/Sprites/Tile 1.png?WALL
Assets/Sprites/Tile 2.png?WALL
Assets/Sprites/Tile 3.png?WALL
Assets/Sprites/Tile 4.png?WALL
Assets/Sprites/Corner 1.png?WALL
Assets/Sprites/Corner 2.png?WALL
Assets/Sprites/Corner 3.png?WALL
Assets/Sprites/Corner 4.png?WALL
Assets/Sprites/Corner 1-3.png?WALL
Assets/Sprites/Corner 2-3.png?WALL
Assets/Sprites/Corner 1-4.png?WALL
Assets/Sprites/Corner 2-4.png?WALL
Assets/Sprites/Floor.png?NORMAL
Assets/Sprites/Door.png?DOOR
Assets/Sprites/TP 1.png?TELEPORTATION
Assets/Sprites/TP 2.png?TELEPORTATION
Assets/Sprites/TP 3.png?TELEPORTATION
Assets/Sprites/TP 4.png?TELEPORTATION
Assets/Sprites/TP 5.png?TELEPORTATION
Assets/Sprites/TP 6.png?TELEPORTATION
Assets/Sprites/TP 7.png?TELEPORTATION
Assets/Sprites/TP 8.png?TELEPORTATION
*
1 0 1 0
0 1 0 1
1 1 0 0
0 0 1 1
0 0 1 0
1 0 0 0
0 1 0 0
0 0 0 1
1 1 1 0
1 1 0 1
1 0 1 1
0 1 1 1
0 0 0 0
0 0 1 1
1 1 0 0
0 0 0 0
0 0 1 1
0 0 0 0
0 0 0 0
1 1 0 0
0 0 0 0
0 0 1 1
{
0,0,9,3,3,3,3,3,3,3,3,3,3,3,3,10,9,3,3,3,3,3,3,3,3,3,3,3,3,10,0,0,
0,0,1,13,13,13,13,13,13,13,13,13,13,13,13,2,1,13,13,13,13,13,13,13,13,13,13,13,13,2,0,0,
0,0,1,13,8,4,4,5,13,8,4,4,4,5,13,2,1,13,8,4,4,4,5,13,8,4,4,5,13,2,0,0,
0,0,1,13,2,13,13,1,13,2,13,13,13,1,13,2,1,13,2,13,13,13,1,13,2,13,13,1,13,2,0,0,
0,0,1,13,7,3,3,6,13,7,3,3,3,6,13,7,6,13,7,3,3,3,6,13,7,3,3,6,13,2,0,0,
0,0,1,13,13,13,13,13,13,13,13,13,13,13,13,13,13,13,13,13,13,13,13,13,13,13,13,13,13,2,0,0,
0,0,1,13,8,4,4,5,13,8,5,13,8,4,4,4,4,4,4,5,13,8,5,13,8,4,4,5,13,2,0,0,
0,0,1,13,7,3,3,6,13,2,1,13,7,3,3,10,9,3,3,6,13,2,1,13,7,3,3,6,13,2,0,0,
0,0,1,13,13,13,13,13,13,2,1,13,13,13,13,2,1,13,13,13,13,2,1,13,13,13,13,13,13,2,0,0,
0,0,11,4,4,4,4,5,13,2,11,4,4,5,13,2,1,13,8,4,4,12,1,13,8,4,4,4,4,12,0,0,
0,0,0,0,0,0,0,1,13,2,9,3,3,6,13,7,6,13,7,3,3,10,1,13,2,0,0,0,0,0,0,0,
0,0,0,0,0,0,0,1,13,2,1,13,13,13,13,13,13,13,13,13,13,2,1,13,2,0,0,0,0,0,0,0,
0,0,0,0,0,0,0,1,13,2,1,13,8,4,4,14,14,4,4,5,13,2,1,13,2,0,0,0,0,0,0,0,
19,15,3,3,3,3,3,6,13,7,6,13,2,13,13,13,13,13,13,1,13,7,6,13,7,3,3,3,3,3,20,19,
18,16,13,13,13,13,13,13,13,13,13,13,2,13,13,13,13,13,13,1,13,13,13,13,13,13,13,13,13,13,21,18,
19,17,4,4,4,4,4,5,13,8,5,13,2,13,13,13,13,13,13,1,13,8,5,13,8,4,4,4,4,4,22,19,
0,0,0,0,0,0,0,1,13,2,1,13,7,3,3,3,3,3,3,6,13,2,1,13,2,0,0,0,0,0,0,0,
0,0,0,0,0,0,0,1,13,2,1,13,13,13,13,13,13,13,13,13,13,2,1,13,2,0,0,0,0,0,0,0,
0,0,0,0,0,0,0,1,13,2,1,13,8,4,4,4,4,4,4,5,13,2,1,13,2,0,0,0,0,0,0,0,
0,0,9,3,3,3,3,6,13,7,6,13,7,3,3,10,9,3,3,6,13,7,6,13,7,3,3,3,3,10,0,0,
0,0,1,13,13,13,13,13,13,13,13,13,13,13,13,2,1,13,13,13,13,13,13,13,13,13,13,13,13,2,0,0,
0,0,1,13,8,4,4,5,13,8,4,4,4,5,13,2,1,13,8,4,4,4,5,13,8,4,4,5,13,2,0,0,
0,0,1,13,7,3,10,1,13,7,3,3,3,6,13,7,6,13,7,3,3,3,6,13,2,9,3,6,13,2,0,0,
0,0,1,13,13,13,2,1,13,13,13,13,13,13,13,13,13,13,13,13,13,13,13,13,2,1,13,13,13,2,0,0,
0,0,11,4,5,13,2,1,13,8,5,13,8,4,4,4,4,4,4,5,13,8,5,13,2,1,13,8,4,12,0,0,
0,0,9,3,6,13,7,6,13,2,1,13,7,3,3,10,9,3,3,6,13,2,1,13,7,6,13,7,3,10,0,0,
0,0,1,13,13,13,13,13,13,2,1,13,13,13,13,2,1,13,13,13,13,2,1,13,13,13,13,13,13,2,0,0,
0,0,1,13,8,4,4,4,4,12,11,4,4,5,13,2,1,13,8,4,4,12,11,4,4,4,4,5,13,2,0,0,
0,0,1,13,7,3,3,3,3,3,3,3,3,6,13,7,6,13,7,3,3,3,3,3,3,3,3,6,13,2,0,0,
0,0,1,13,13,13,13,13,13,13,13,13,13,13,13,13,13,13,13,13,13,13,13,13,13,13,13,13,13,2,0,0,
0,0,11,4,4,4,4,4,4,4,4,4,4,4,4,4,4,4,4,4,4,4,4,4,4,4,4,4,4,12,0,0
}
0, 14, LEFT , 30, 14, RIGHT $
Assets/Sprites/Point 1.png?NORMAL 10
Assets/Sprites/Point 2.png?POWER 50
{
0,0,0,0,0,0,0,0,0,0,0,0,0,0,0,0,0,0,0,0,0,0,0,0,0,0,0,0,0,0,0,0,
0,0,0,23,23,23,23,23,23,23,23,23,23,23,23,0,0,23,23,23,23,23,23,23,23,23,23,23,23,0,0,0,
0,0,0,23,0,0,0,0,23,0,0,0,0,0,23,0,0,23,0,0,0,0,0,23,0,0,0,0,23,0,0,0,
0,0,0,24,0,0,0,0,23,0,0,0,0,0,23,0,0,23,0,0,0,0,0,23,0,0,0,0,24,0,0,0,
0,0,0,23,0,0,0,0,23,0,0,0,0,0,23,0,0,23,0,0,0,0,0,23,0,0,0,0,23,0,0,0,
0,0,0,23,23,23,23,23,23,23,23,23,23,23,23,23,23,23,23,23,23,23,23,23,23,23,23,23,23,0,0,0,
0,0,0,23,0,0,0,0,23,0,0,23,0,0,0,0,0,0,0,0,23,0,0,23,0,0,0,0,23,0,0,0,
0,0,0,23,0,0,0,0,23,0,0,23,0,0,0,0,0,0,0,0,23,0,0,23,0,0,0,0,23,0,0,0,
0,0,0,23,23,23,23,23,23,0,0,23,23,23,23,0,0,23,23,23,23,0,0,23,23,23,23,23,23,0,0,0,
0,0,0,0,0,0,0,0,23,0,0,0,0,0,0,0,0,0,0,0,0,0,0,23,0,0,0,0,0,0,0,0,
0,0,0,0,0,0,0,0,23,0,0,0,0,0,0,0,0,0,0,0,0,0,0,23,0,0,0,0,0,0,0,0,
0,0,0,0,0,0,0,0,23,0,0,0,0,0,0,0,0,0,0,0,0,0,0,23,0,0,0,0,0,0,0,0,
0,0,0,0,0,0,0,0,23,0,0,0,0,0,0,0,0,0,0,0,0,0,0,23,0,0,0,0,0,0,0,0,
0,0,0,0,0,0,0,0,23,0,0,0,0,0,0,0,0,0,0,0,0,0,0,23,0,0,0,0,0,0,0,0,
0,0,0,0,0,0,0,0,23,0,0,0,0,0,0,0,0,0,0,0,0,0,0,23,0,0,0,0,0,0,0,0,
0,0,0,0,0,0,0,0,23,0,0,0,0,0,0,0,0,0,0,0,0,0,0,23,0,0,0,0,0,0,0,0,
0,0,0,0,0,0,0,0,23,0,0,0,0,0,0,0,0,0,0,0,0,0,0,23,0,0,0,0,0,0,0,0,
0,0,0,0,0,0,0,0,23,0,0,0,0,0,0,0,0,0,0,0,0,0,0,23,0,0,0,0,0,0,0,0,
0,0,0,0,0,0,0,0,23,0,0,0,0,0,0,0,0,0,0,0,0,0,0,23,0,0,0,0,0,0,0,0,
0,0,0,0,0,0,0,0,23,0,0,0,0,0,0,0,0,0,0,0,0,0,0,23,0,0,0,0,0,0,0,0,
0,0,0,23,23,23,23,23,23,23,23,23,23,23,23,0,0,23,23,23,23,23,23,23,23,23,23,23,23,0,0,0,
0,0,0,23,0,0,0,0,23,0,0,0,0,0,23,0,0,23,0,0,0,0,0,23,0,0,0,0,23,0,0,0,
0,0,0,23,0,0,0,0,23,0,0,0,0,0,23,0,0,23,0,0,0,0,0,23,0,0,0,0,23,0,0,0,
0,0,0,24,23,23,0,0,23,23,23,23,23,23,23,0,0,23,23,23,23,23,23,23,0,0,23,23,24,0,0,0,
0,0,0,0,0,23,0,0,23,0,0,23,0,0,0,0,0,0,0,0,23,0,0,23,0,0,23,0,0,0,0,0,
0,0,0,0,0,23,0,0,23,0,0,23,0,0,0,0,0,0,0,0,23,0,0,23,0,0,23,0,0,0,0,0,
0,0,0,23,23,23,23,23,23,0,0,23,23,23,23,0,0,23,23,23,23,0,0,23,23,23,23,23,23,0,0,0,
0,0,0,23,0,0,0,0,0,0,0,0,0,0,23,0,0,23,0,0,0,0,0,0,0,0,0,0,23,0,0,0,
0,0,0,23,0,0,0,0,0,0,0,0,0,0,23,0,0,23,0,0,0,0,0,0,0,0,0,0,23,0,0,0,
0,0,0,23,23,23,23,23,23,23,23,23,23,23,23,23,23,23,23,23,23,23,23,23,23,23,23,23,23,0,0,0,
0,0,0,0,0,0,0,0,0,0,0,0,0,0,0,0,0,0,0,0,0,0,0,0,0,0,0,0,0,0,0,0
}
256 360
12 12