32x31
Assets/Sprites/Tile 1.png?WALL
Assets/Sprites/Tile 2.png?WALL
Assets/Sprites/Tile 3.png?WALL
Assets/Sprites/Tile 4.png?WALL
Assets/Sprites/Corner 1.png?WALL
Assets/Sprites/Corner 2.png?WALL
Assets/Sprites/Corner 3.png?WALL
Assets/Sprites/Corner 4.png?WALL
Assets/Sprites/Corner 1-3.png?WALL
Assets/Sprites/Corner 2-3.png?WALL
Assets/Sprites/Corner 1-4.png?WALL
Assets/Sprites/Corner 2-4.png?WALL
Assets/Sprites/Floor.png?NORMAL
Assets/Sprites/Door.png?WALL
Assets/Sprites/Floor.png?TELEPORTATION
Assets/Sprites/Floor.png?TELEPORTATION
Assets/Sprites/Floor.png?TELEPORTATION
*
1 0 1 0
0 1 0 1
1 1 0 0
0 0 1 1
0 0 1 0
1 0 0 0
0 1 0 0
0 0 0 1
1 1 1 0
1 1 0 1
1 0 1 1
0 1 1 1
0 0 0 0
0 0 1 1
1 1 0 0
0 0 0 0
0 0 1 1
{
0,0,9,3,3,3,3,3,3,3,3,3,3,3,3,10,9,3,3,3,3,3,3,3,3,3,3,3,3,10,0,0,
0,0,1,13,13,13,13,13,13,13,13,13,13,13,13,2,1,13,13,13,13,13,13,13,13,13,13,13,13,2,0,0,
0,0,1,13,8,4,4,5,13,8,4,4,4,5,13,2,1,13,8,4,4,4,5,13,8,4,4,5,13,2,0,0,
0,0,1,13,2,13,13,1,13,2,13,13,13,1,13,2,1,13,2,13,13,13,1,13,2,13,13,1,13,2,0,0,
0,0,1,13,7,3,3,6,13,7,3,3,3,6,13,7,6,13,7,3,3,3,6,13,7,3,3,6,13,2,0,0,
0,0,1,13,13,13,13,13,13,13,13,13,13,13,13,13,13,13,13,13,13,13,13,13,13,13,13,13,13,2,0,0,
0,0,1,13,8,4,4,5,13,8,5,13,8,4,4,4,4,4,4,5,13,8,5,13,8,4,4,5,13,2,0,0,
0,0,1,13,7,3,3,6,13,2,1,13,7,3,3,10,9,3,3,6,13,2,1,13,7,3,3,6,13,2,0,0,
0,0,1,13,13,13,13,13,13,2,1,13,13,13,13,2,1,13,13,13,13,2,1,13,13,13,13,13,13,2,0,0,
0,0,11,4,4,4,4,5,13,2,11,4,4,5,13,2,1,13,8,4,4,12,1,13,8,4,4,4,4,12,0,0,
0,0,0,0,0,0,0,1,13,2,9,3,3,6,13,7,6,13,7,3,3,10,1,13,2,0,0,0,0,0,0,0,
0,0,0,0,0,0,0,1,13,2,1,13,13,13,13,13,13,13,13,13,13,2,1,13,2,0,0,0,0,0,0,0,
0,0,0,0,0,0,0,1,13,2,1,13,8,4,4,14,14,4,4,5,13,2,1,13,2,0,0,0,0,0,0,0,
15,15,3,3,3,3,3,6,13,7,6,13,2,13,13,13,13,13,13,1,13,7,6,13,7,3,3,3,3,3,15,15,
16,16,13,13,13,13,13,13,13,13,13,13,2,13,13,13,13,13,13,1,13,13,13,13,13,13,13,13,13,13,16,16,
17,17,4,4,4,4,4,5,13,8,5,13,2,13,13,13,13,13,13,1,13,8,5,13,8,4,4,4,4,4,17,17,
0,0,0,0,0,0,0,1,13,2,1,13,7,3,3,3,3,3,3,6,13,2,1,13,2,0,0,0,0,0,0,0,
0,0,0,0,0,0,0,1,13,2,1,13,13,13,13,13,13,13,13,13,13,2,1,13,2,0,0,0,0,0,0,0,
0,0,0,0,0,0,0,1,13,2,1,13,8,4,4,4,4,4,4,5,13,2,1,13,2,0,0,0,0,0,0,0,
0,0,9,3,3,3,3,6,13,7,6,13,7,3,3,10,9,3,3,6,13,7,6,13,7,3,3,3,3,10,0,0,
0,0,1,13,13,13,13,13,13,13,13,13,13,13,13,2,1,13,13,13,13,13,13,13,13,13,13,13,13,2,0,0,
0,0,1,13,8,4,4,5,13,8,4,4,4,5,13,2,1,13,8,4,4,4,5,13,8,4,4,5,13,2,0,0,
0,0,1,13,7,3,10,1,13,7,3,3,3,6,13,7,6,13,7,3,3,3,6,13,2,9,3,6,13,2,0,0,
0,0,1,13,13,13,2,1,13,13,13,13,13,13,13,13,13,13,13,13,13,13,13,13,2,1,13,13,13,2,0,0,
0,0,11,4,5,13,2,1,13,8,5,13,8,4,4,4,4,4,4,5,13,8,5,13,2,1,13,8,4,12,0,0,
0,0,9,3,6,13,7,6,13,2,1,13,7,3,3,10,9,3,3,6,13,2,1,13,7,6,13,7,3,10,0,0,
0,0,1,13,13,13,13,13,13,2,1,13,13,13,13,2,1,13,13,13,13,2,1,13,13,13,13,13,13,2,0,0,
0,0,1,13,8,4,4,4,4,12,11,4,4,5,13,2,1,13,8,4,4,12,11,4,4,4,4,5,13,2,0,0,
0,0,1,13,7,3,3,3,3,3,3,3,3,6,13,7,6,13,7,3,3,3,3,3,3,3,3,6,13,2,0,0,
0,0,1,13,13,13,13,13,13,13,13,13,13,13,13,13,13,13,13,13,13,13,13,13,13,13,13,13,13,2,0,0,
0,0,11,4,4,4,4,4,4,4,4,4,4,4,4,4,4,4,4,4,4,4,4,4,4,4,4,4,4,12,0,0
}
0, 14, LEFT , 30, 14, RIGHT $
Assets/Sprites/Point 1.png?NORMAL 10
Assets/Sprites/Point 2.png?POWER 50
{
0,0,0,0,0,0,0,0,0,0,0,0,0,0,0,0,0,0,0,0,0,0,0,0,0,0,0,0,0,0,0,0,
0,0,0,18,18,18,18,18,18,18,18,18,18,18,18,0,0,18,18,18,18,18,18,18,18,18,18,18,18,0,0,0,
0,0,0,18,0,0,0,0,18,0,0,0,0,0,18,0,0,18,0,0,0,0,0,18,0,0,0,0,18,0,0,0,
0,0,0,19,0,0,0,0,18,0,0,0,0,0,18,0,0,18,0,0,0,0,0,18,0,0,0,0,19,0,0,0,
0,0,0,18,0,0,0,0,18,0,0,0,0,0,18,0,0,18,0,0,0,0,0,18,0,0,0,0,18,0,0,0,
0,0,0,18,18,18,18,18,18,18,18,18,18,18,18,18,18,18,18,18,18,18,18,18,18,18,18,18,18,0,0,0,
0,0,0,18,0,0,0,0,18,0,0,18,0,0,0,0,0,0,0,0,18,0,0,18,0,0,0,0,18,0,0,0,
0,0,0,18,0,0,0,0,18,0,0,18,0,0,0,0,0,0,0,0,18,0,0,18,0,0,0,0,18,0,0,0,
0,0,0,18,18,18,18,18,18,0,0,18,18,18,18,0,0,18,18,18,18,0,0,18,18,18,18,18,18,0,0,0,
0,0,0,0,0,0,0,0,18,0,0,0,0,0,0,0,0,0,0,0,0,0,0,18,0,0,0,0,0,0,0,0,
0,0,0,0,0,0,0,0,18,0,0,0,0,0,0,0,0,0,0,0,0,0,0,18,0,0,0,0,0,0,0,0,
0,0,0,0,0,0,0,0,18,0,0,0,0,0,0,0,0,0,0,0,0,0,0,18,0,0,0,0,0,0,0,0,
0,0,0,0,0,0,0,0,18,0,0,0,0,0,0,0,0,0,0,0,0,0,0,18,0,0,0,0,0,0,0,0,
0,0,0,0,0,0,0,0,18,0,0,0,0,0,0,0,0,0,0,0,0,0,0,18,0,0,0,0,0,0,0,0,
0,0,0,0,0,0,0,0,18,0,0,0,0,0,0,0,0,0,0,0,0,0,0,18,0,0,0,0,0,0,0,0,
0,0,0,0,0,0,0,0,18,0,0,0,0,0,0,0,0,0,0,0,0,0,0,18,0,0,0,0,0,0,0,0,
0,0,0,0,0,0,0,0,18,0,0,0,0,0,0,0,0,0,0,0,0,0,0,18,0,0,0,0,0,0,0,0,
0,0,0,0,0,0,0,0,18,0,0,0,0,0,0,0,0,0,0,0,0,0,0,18,0,0,0,0,0,0,0,0,
0,0,0,0,0,0,0,0,18,0,0,0,0,0,0,0,0,0,0,0,0,0,0,18,0,0,0,0,0,0,0,0,
0,0,0,0,0,0,0,0,18,0,0,0,0,0,0,0,0,0,0,0,0,0,0,18,0,0,0,0,0,0,0,0,
0,0,0,18,18,18,18,18,18,18,18,18,18,18,18,0,0,18,18,18,18,18,18,18,18,18,18,18,18,0,0,0,
0,0,0,18,0,0,0,0,18,0,0,0,0,0,18,0,0,18,0,0,0,0,0,18,0,0,0,0,18,0,0,0,
0,0,0,18,0,0,0,0,18,0,0,0,0,0,18,0,0,18,0,0,0,0,0,18,0,0,0,0,18,0,0,0,
0,0,0,19,18,18,0,0,18,18,18,18,18,18,18,0,0,18,18,18,18,18,18,18,0,0,18,18,19,0,0,0,
0,0,0,0,0,18,0,0,18,0,0,18,0,0,0,0,0,0,0,0,18,0,0,18,0,0,18,0,0,0,0,0,
0,0,0,0,0,18,0,0,18,0,0,18,0,0,0,0,0,0,0,0,18,0,0,18,0,0,18,0,0,0,0,0,
0,0,0,18,18,18,18,18,18,0,0,18,18,18,18,0,0,18,18,18,18,0,0,18,18,18,18,18,18,0,0,0,
0,0,0,18,0,0,0,0,0,0,0,0,0,0,18,0,0,18,0,0,0,0,0,0,0,0,0,0,18,0,0,0,
0,0,0,18,0,0,0,0,0,0,0,0,0,0,18,0,0,18,0,0,0,0,0,0,0,0,0,0,18,0,0,0,
0,0,0,18,18,18,18,18,18,18,18,18,18,18,18,18,18,18,18,18,18,18,18,18,18,18,18,18,18,0,0,0,
0,0,0,0,0,0,0,0,0,0,0,0,0,0,0,0,0,0,0,0,0,0,0,0,0,0,0,0,0,0,0,0
}
190 360
12 12